21 14
AAAAAAAAAAASAAAAAAAAD
AAAAAAAAAAAAAAAAHHAAA
AOAASAAOAASAAAATAAAAA
AAAAAATAAABAAOAAAAAAA
AAAAAAAAAAAATAAAAAAAA
AAAAAAAATAABAAAAAADAA
AAAAAAAAAAAAAOAAAAAAA
DDDAAAAATAAAAAAAHHOAA
TDDAAAAAAAAAAAADAAAAA
AAAASSAAAAAAAAAAHHAAA
AAAAAAAAAAAAAAADAAAAA
AAAAAOAAAAAOOAAAAAAAA
AAAAAAAAAAAAAAADHHAAA
AAAAOAAAAAATDDDDDDDDD
