21 14
TTTTTTTAAAAAAAAAAAAAT
AAAAAAAAAAAAAAAAHHAAA
AOAAAAAOAAAAAAAAAAAAA
AAAAADATAABAAOAAAAAAA
AAAAAAAAAAAAAAAAAAAAA
AAAAAAAAAAABAAAAAATAA
AAAAAAAAAAAAAOAAAAAAA
TTTAAAATAAAAAAAAHHOAA
ATTAAAAAAAAAAAATAAAAA
AAAAAAAAAAAAAAAAHHAAA
AAAAADAAAAAAAAATAAAAA
AAAAAOAAAAAOOAAAAAAAA
AAAAAAAAAAAAAATTHHAAA
AAAAOAAAAAAAAADAAAAAT
