21 14
TTTTTTTAAAAAAAAAAAAAT
AAAAAAAAAAAAAAPPAHAAA
AOAAAAAOAAAAAPPPPAAAA
AAAAADATAABAAAPAAAAAA
AAAAAAAAAAAAAAAAAAAAA
AAAAAAAAAAABAAAAAATAA
AAAAAAAAAAAAAOAAAAAAA
TTTAAAATAAAAAAAAHHOAA
ATTAAAAAAAAAAAATAAAAA
AAAAAAAAAAAAAAAAHHAAA
AAAAADAAAAAAAAATAAAAA
AAAAAOAAAAAOOAAAAAAAA
AAAAAAAAAAAAAATTHHAAA
AAAAOAAAAAAAADAAAAAAT
